R	1920000000000 10805255

NO	./textures/redbrick.xpm
SO	./textures/wood.xpm
WE	./textures/eagle.xpm
EA	./textures/greystone.xpm
S	./textures/pillar.xpm

C	50,50,255
F 0,00,0



111111
100N011 1
1000001
100000111
1111111
