R	1080 1004

NO	./textures/redbrick.xpm
SO	./textures/wood.xpm
WE	./textures/eagle.xpm
EA	./textures/greystone.xpm
S	./textures/eagle.xpm

F 000,100,0
C	50,50,055



111111111111111111111111111111111
100000000000000000000000000000001
10S000000000000000000000000000001
100000000000000000000000000000001
100100000222222222222220000000001
100100000000000000000000000000001
100100000222222222222220000000001
100100000000000000000000000000001
100100000000000000000000000000001
100000000000000000000000000000001
100000000000000000000000000000001
100000000000000000000000000000001
100000000000000000000000000000001
100000000000000000000000000000001
100000000000000000000000000000001
111111111111111111111111111111101
111111111111111111111111111111111


