R	1280 1024

NO	./textures/redbrick.xpm
SO	./textures/wood.xpm
WE	./textures/eagle.xpm
EA	./textures/greystone.xpm
S	./textures/eagle.xpm

F 220,100,0
C	50,50,255



111111111111111111111111111111111
100000000000000000000000000000001
10S000000000000200000000000000001
100000000200000000002000000000001
100100000000000200000000020000001
100100020020020000000000200000001
100100000000000200000000000000001
100100000000000000000000200000001
100100000000020002000000000000001
100000000000000000000020002000001
100000000000000000000000020000001
100000000002000000002000000000001
100020000020000000000000000000001
100002000000000000022000000000001
100000000000000000000000000000001
111111111111111111111111111111101
111111111111111111111111111111111


