R	1000 1000

NO	./textures/redbrick.xpm
SO	./textures/wood.xpm
WE	./textures/eagle.xpm
EA	./textures/greystone.xpm
S	./textures/pillar.xpm

F 220,100,0
C	50,50,255



111111111111111111111111111111111
100000000000000000000000000000001
100000000000000000000000000000001
100000000000000000000000000000001
100000000000000000000000000000001
100000000000000000000000000000001
100000000000000000000000000000001
100000000000000000000000000000001
100000000000000000000000020000001
100000000000000000000000020000001
100000000000000000000000000000001
100000000000000000000000000000001
100000000000000000000000000000001
100000000000000000000000000000001
100000000000000000000000000000001
111111111111111111111111111111101
        1111111111111111111111101
        1000000000110000000000001
        10110000011100E0000000001
        1001000000000000000000201
111111111011000001110000000000001
100000000011000001110111111111111
11110111111111011100000010001
11110111111111011101010010001
11000000110101011100000010001
10002000000000001100000010001
10000000000000001101010010001
1100000111010101111101111000111
11110111 1110101 101111010001
11111111 1111111 111111111111


